EA ./textures/bluestone.png
WE ./textures/colorstone.png
NO ./textures/mossy.png
SO ./textures/mossy.png


C 225,30,0
F 220,100,0


        0111101111001111111000001
        1000010000110000000111110
        1011000001110000000000001
        1001000000000000000000001
111111111011000001110000000000001
10000000001100000111011111D111111
01110111111111011100000010001
01110111111111011101010000001
11000000110101011100000010001
10000000000000001100000010001
10000000000000001101010010001
11000001110101011111011110N0111
00110111 1110101 101111010001
   11111 1111111 111111111111